1111111111111
1P0100000C001
100001110C001
10E0110000001
1111111111111
